21
21
#####################
#A#_________#_#_____#
#_#_#####_#_#_#_###_#
#_#_____#_#_____#___#
#_#######_#######_###
#_#_______#_#___#_#_#
#_#_#######_#_#_#_#_#
#_#___#B__#___#_#___#
#_###_###_#_#########
#___#___#_____#_____#
###_###_#####_#_#####
#_#___#_#___#_#___#_#
#_###_#_###_#_###_#_#
#___#___#_#_#_______#
#_#_###_#_#_#_#_#####
#_#_____#___#_#_____#
###_###_#_###_#####_#
#___#___#___#_#_#___#
#_#_#######_###_#_#_#
#_#_______________#_#
#####################
